1,2,3,2,4,2,5,6,7,4
4,2,7,1,7,3,5,9,9,1
4,2,9,8,7,5,1,9,6,5
4,2,9,3,3,4,9,5,8,6
3,8,7,3,8,6,9,7,8,5
2,3,7,3,7,6,9,3,6,8
4,9,2,8,7,5,2,9,8,4
5,2,7,7,7,7,7,7,7,2
5,3,4,9,7,9,2,7,6,4
5,3,4,9,2,7,2,7,6,9